{
  "a": 2,
  "á": 2,
  "à": 2,
  "ã": 2,
  "ä": 2,
  "â": 2,
  "b": 3,
  "c": 5,
  "ç": 5,
  "d": 7,
  "b": 11,
  "e": 13,
  "é": 13,
  "è": 13,
  "ë": 13,
  "ê": 13,
  "f": 17,
  "g": 19,
  "h": 23,
  "i": 29,
  "í": 29,
  "ì": 29,
  "ï": 29,
  "î": 29,
  "j": 31,
  "k": 37,
  "l": 41,
  "m": 43,
  "n": 47,
  "o": 53,
  "ó": 53,
  "ò": 53,
  "õ": 53,
  "ö": 53,
  "ô": 53,
  "p": 59,
  "q": 61,
  "r": 67,
  "s": 71,
  "t": 73,
  "u": 79,
  "ú": 79,
  "ù": 79,
  "ü": 79,
  "û": 79,
  "v": 83,
  "w": 89,
  "x": 97,
  "y": 101,
  "z": 103
}
